at the Joy Luck Club	在 喜福会
at the mah jong table	于 两 个 月 前
of a cerebral aneurysm	据 医生 说 于 脑动脉瘤
at the Joy Luck Club like a rabbit : quickly and with unfinished business left behind like a rabbit : quickly with unfinished business left behind	像 只 兔子 一样
of the Joy Luck Club	与 她 的 朋友 由 她
of the Joy Luck Club in 1949	在 1949年 我 出 世 前 两 年
to my father	直到 上 船 之后 向 父亲 解释 往 里面
between the slippery silks for his cotton shirts and wool pants	在 一 大 堆 凉飕飕 的 丝绸 间
in San Francisco	等 他们 抵达 旧金山
in sizes for American women for American women	直到 难民 收容 团体
of a group of white-haired American missionary ladies from the First Chinese Baptist Church of white-haired American missionary ladies from the First Chinese Baptist Church from the First Chinese Baptist Church	由 该地 第一 中国 浸礼 会 的 一 群 白头发 美籍 太太们
because of their gifts	由于 接受 了 她们 的 施舍
of these families in China in their fragile English	到 这些 女人 们 在 中国
in these women 's faces	从 她们 的 漠然 惆怅 的 脸上
for the Joy Luck Club	当 她 向 她们 建议 ， 发起 喜福会 时 向 她们
from the days of her first marriage of her first marriage in Kweilin	在 日军 占领 桂林 前
after another	每当 她 把 碗碟 擦 干净 在 报纸 后面
of old ski sweaters sent to us by unseen relatives from Vancouver to us by unseen relatives from Vancouver	在 温哥华 的 一个 从 未 见 过 面 的 亲戚
about Kweilin	用 中国话 在 还 未 去 桂林 前
for food	在 河面 上 以 浮萍 果腹
in your life	至 顶峰 因 眼前 袒露 的 一切
In China about Kweilin	在 中国
at the same time	当 我 看见 真正 桂林 的 山峦
Behind each hill of another fish	与 山 之间
to Kweilin	和 两 个 婴儿 为了 躲避 战火
with the Kuomintang in a small room in a two-story house in a two-story house to the northwest to Chungking	当 他 把 我们 安置 在 一 幢 二 层 楼房 的 小房间 里 后 在 一 幢 二 层 楼房 的 小房间 里
of people into the city for places	在 人行道 上
of course , the Kuomintang and their army officers to everyone else	以 高人一等 的 姿态
into their hands	用 手 用 那 擤鼻涕 的 手
for me	因 此 你 能 想象 对 我
outside	在 洞 外
like newborn kittens to the city	因 此 一旦 轰 炸声 远 去 像 刚 下地 的 小猫崽
on a summer night to the ground with the damp heat	在 一个 酷暑 煎 人 的 晚上
from the sewers rose up to my second-story window and the stink had nowhere else to go but into my nose to my second-story window but into my nose into my nose	从 楼下 阴沟 里 往 四下 弥散 ， 直 冲着 二 楼 我 的 窗棂 往 四下 弥散 直 冲着 二 楼 我 的 窗棂 冲着 二 楼 我 的 窗棂
of a runaway pig for lying in his way on the sidewalk in his way on the sidewalk on the sidewalk	在 杀猪
like me with wishful faces	像 我
with only a little money	在 逃难 出来 时
of us	与 一个 老头 给 她
to with our meager allowances	以 我们 菲薄 的 经济 力量
to protest how we could not eat another bite to protest from earlier in the day in the day	因 食物 因为 实在 吃 不 下 了 打从 聚 会日
