My father has asked me to be the fourth corner at the Joy Luck Club.	我 爸 要 我 在 喜福会 的 麻将 台 边 的 一 方 ， 取代 我 已故 的 母亲 。													
"I am to replace my mother, whose seat at the mah jong table has been empty since she died two months ago."	她 已 于 两 个 月 前 去世 。 打 这 以来 ， 这 麻将 台 边 的 座位 就 一直 空缺 着 。													
My father thinks she was killed by her own thoughts.	爸 认为 ， 妈 是 让 她 自己 心中 的 某个 念头 折磨 死 的 。													
It must have been a very bad idea.	这 必 是 一个 坏 念头 。 ”													
The doctor said she died of a cerebral aneurysm.	据 医生 说 ， 她 是 殁 于 脑动脉瘤 。
And her friends at the Joy Luck Club said she died just like a rabbit: quickly and with unfinished business left behind.	她 的 喜福会 里 的 朋友 们 说 ， 她 去 得 很 快 ， 就 像 只 兔子 一样 “嗖 ” 一 下 就 不见了 。													
My mother was supposed to host the next meeting of the Joy Luck Club.	本来 ， 母亲 已 与 她 的 朋友 约定 ， 下 一 轮 的 喜福会 聚会 ， 将 由 她 做东 。													
"Don't show off, I said."""	“ 别 夸耀 了 。 ” 我 说 。													
It's not showoff.	“ 我 没有 夸耀 。 ” 她 说 ， “ 这 两 种 汤 差不多 是 一样 的 。 ”													
"My mother started the San Francisco version of the Joy Luck Club in 1949, two years before I was born."	母亲 在 1949年 我 出 世 前 两 年 ， 就 开始 有 办 个 旧金山 喜福会 的 念头 的 。													
This was the year my mother and father left China with one stiff leather trunk filled only with fancy silk dresses.	就是 这 一 年 ， 我 父母 带 着 一 只 破壳 皮箱 离开 中国 ， 皮箱 里 装满 的 ， 只是 一 箱 漂亮 的 丝绸	衣服 。												
"There was no time to pack anything else, my mother had explained to my father after they boarded the boat."	直到 上 船 之后 ， 她 才 向 父亲 解释 道 ： 实在 来不及 再 往 里面 塞 其他 物品 了 。													
"Still his hands swam frantically between the slippery silks, looking for his cotton shirts and wool pants."	尽管如此 ， 父亲 还 是 徒劳 地 在 一 大 堆 凉飕飕 的 丝绸 间 胡乱 掀动 ， 企图 寻找 他 的 棉布 衬衫 和	羊毛裤	。											
"When they arrived in San Francisco, my father made her hide those shiny clothes."	等 他们 抵达 旧金山 ， 父亲 便 令她 藏起 那些 亮晃晃 的 衣服 。													
"She wore the same brown-checked Chinese dress until the Refugee Welcome Society gave her two hand-me-down dresses, all too large in sizes for American women."	从此 ， 她 就者 穿 着 那件 棕色 格子 的 中装 ， 直到 难民 收容 团体 送给 她 两 件 旧衣服 。 然而 这些	衣服 都	是	美国	人	的	尺	寸 ， 穿在	她	身	上	晃	荡	晃荡 的 。
The society was composed of a group of white-haired American missionary ladies from the First Chinese Baptist Church.	这个 难民 收容 团体 是 由 该地 第一 中国 浸礼 会 的 一 群 白头发 美籍 太太们 发起 的 。													
"And because of their gifts, my parents could not refuse their invitation to join the church."	由于 接受 了 她们 的 施舍 ， 我 父母 就 只能 听从 她们 的 劝导 开始 上教堂 了 。													
"Nor could they ignore the old ladies' practical advice to improve their English through Bible study class on Wednesday nights and, later, through choir practice on Saturday mornings."	当然 ， 她们 的 劝导 十分 实惠 中肯 ， 但 其中 一个 很 大 的 因素 就是 ； 每周三 晚上 的 读经 班 及 周	六 早 上	的	合唱	练	习	，	都 可以	帮助	他	们	提	高	英语 程度 。
"This was how my parents met the Hsus, the Jongs, and the St. Clairs."	就 是 这样 ， 我 父母 得以 认识 许 家 、 龚 家及 圣克莱尔 家 。													
My mother could sense that the women of these families also had unspeakable tragedies they had left behind in China and hopes they couldn't begin to express in their fragile English.	我 母亲 能 感觉 到 这些 女人 们 也 各自 有 她们 的 隐痛 ， 她们 遗失 在 中国 的 梦幻 和 希望 。 然而 她	们 蹩脚	的	英语	，	很	难	使 她们	将	此	一	吐	为快	。
"Or at least, my mother recognized the numbness in these women's faces."	或者 说 ， 至少 ， 我 母亲 ， 已 从 她们 的 漠然 惆怅 的 脸上 ， 读出 了 什么 。													
And she saw how quickly their eyes moved when she told them her idea for the Joy Luck Club.	因此 ， 当 她 向 她们 建议 ， 发起 喜福会 时 ， 她们 立即 就 赞同 了 。													
"Joy Luck was an idea my mother remembered from the days of her first marriage in Kweilin, before the Japanese came."	喜福会 这 一 名字 ， 起 缘于 我 母亲 的 第一 次 婚姻 ， 那 还 是 在 日军 占领 桂林 前 。													
That's why I think of Joy Luck as her Kweilin story.	所以 一提到 喜福会 ， 就 会 使 我 想到 她 的 桂林 故事 。													
"It was the story she would always tell me when she was bored, when there was nothing to do, when every bowl had been washed and the Formica table had been wiped down twice, when my father sat reading the newspaper and smoking one Pall Mall cigarette after another, a warning not to disturb him."	每当 她 把 碗碟 擦 干净 ， 塑料 台面 也 已 擦拭 了 两 个 来回 ， 而 父亲 已 开始 将 脸 躲 在 报纸 后面	， 一 支	接	一	支	地	抽	他 的 黑	猫	牌	香	烟	——	这 往往 是 一 种 “ 不要 打搅 ” 的 警告 ， 这 便 是 她 觉得 无所事事 之 时 ， 于是 ， 她 便 会 对 我 讲 起 她 的 往事 。
This is when my mother would take out a box of old ski sweaters sent to us by unseen relatives from Vancouver.	这个 时候 她 总会 拉 出 一 箱 旧 毛衣 ， 那 是 我们 在 温哥华 的 一个 从 未 见 过 面 的 亲戚 送给 我们	的 。												
"Over the years, she told me the same story, except for the ending, which grew darker, casting long shadows into her life, and eventually into mine."	数 年 来 ， 她 重复 讲述 着 同 一个 故事 ， 只是 故事 的 结局 ， 一 次 比 一 次 黯淡 ， 犹如 她 自己 生	活 中 的	一	道	浓	重	的	阴影 。 而	今	，	这	道	阴	影 ， 也 渗入 到 了 我 的 生活 中 。
"I dreamed about Kweilin before I ever saw it, my mother began, speaking Chinese."""	我 母亲 总是 用 中国话 开始 她 的 叙述 ： “ 我 在 还 未 去 桂林 前 ， 就 梦见 它 好几 回 了 。													
"I dreamed of jagged peaks lining a curving river, with magic moss greening the banks."	群山 环绕 中 ， 一 条 小河 蜿蜒 而 过 ， 河 上 漂 着 青色 的 浮萍 。													
At the tops of these peaks were white mists.	天幕 上 衬着 锯齿 般的 山峦 ， 层层叠叠 的 ， 白云 缭绕 其间 。													
"And if you could float down this river and eat the moss for food, you would be strong enough to climb the peak."	如果 你 在 河面 上 漂浮 ， 仅 以 浮萍 果腹 ， 也 能 毫无 难色 地 爬 上 山峰 。													
"If you slipped, you would only fall into a bed of soft moss and laugh."	如果 你 不慎 滑 跌 下来 ， 也 只 是 坠入 一 张 柔软 的 浮萍 织成 的 大 床 上 。													
"And once you reached the top, you would be able to see everything and feel such happiness it would be enough to never have worries in your life ever again."	一旦 你 爬 至 顶峰 ， 你 会 因 眼前 袒露 的 一切 而 欣喜若狂 ， 它 会涤 净 你 的 一切 烦恼 不快 ， 扫	尽 一切	腌臢	之	气	。								
"In China, everybody dreamed about Kweilin."	“ 在 中国 ， 素有 桂林 山水 甲天下 之 说 ， 人人 都 梦想 着 桂林 。													
"And when I arrived, I realized how shabby my dreams were, how poor my thoughts."	然而 我 到 了 那里 ， 才 发现 ， 我 的 桂林 梦 竟是 那般 小家子气 ， 我 的 想象力 是 那样 狭窄 贫乏 。													
"When I saw the hills, I laughed and shuddered at the same time."	当 我 看见 真正 桂林 的 山峦 ， 我 笑 了 ， 同时 也 颤抖 了 。													
The peaks looked like giant fried fish heads trying to jump out of a vat of oil.	这些 山峦 ， 活像 大 堆 妄图 跳出 油锅 的 煎鱼 。													
"Behind each hill, I could see shadows of another fish, and then another and another."	山 与 山 之间 层层叠叠 ， 影影憧憧 ， 似 没有 个 尽头 。													
And then the clouds would move just a little and the hills would suddenly become monstrous elephants marching slowly toward me!	然而 只要 云层 稍稍 移动 一下 ， 这些 山峦 突然 又 变 了 ， 有时 会 像 一 群 逼近 的 象 群 。													
Can you see this?	你 能 想象 吗 ？													
The man who was my husband brought me and our two babies to Kweilin because he thought we would be safe.	我 男人 ， 把 我 和 两 个 婴儿 带 到 桂林 ， 是 为了 躲避 战火 ， 他 以为 这里 安全 些 。													
"He was an officer with the Kuomintang, and after he put us down in a small room in a two-story house, he went off to the northwest, to Chungking."	他 是 个 国民党 军官 ， 当 他 把 我们 安置 在 一 幢 二 层 楼房 的 小房间 里 后 ， 便 只身 一 人 去 了	重庆 。												
"We knew the Japanese were winning, even when the newspapers said they were not."	“ 我们 知道 日本 人 步步 挺进 ， 国军 节节败退 ， 尽管 报 上 从来 不 这样 说 。													
"Every day, every hour, thousands of people poured into the city, crowding the sidewalks, looking for places to live."	每日 每时 ， 都 有 成千上万 的 难民 拥进 城里 ， 簇拥 在 人行道 上 ， 四处 寻觅 栖身 之 处 。													
"And there was, of course, the Kuomintang and their army officers who thought they were top level to everyone else."	当然 ， 也 有 国民党 官兵 ， 他们 以 高人一等 的 姿态 自居 。 “ 这 简直 成 了 个 大杂烩 。													
Everybody looked down on someone else.	大家 互相 不买账 。													
"Oh, I hated the American air force officers who said habba-habba sounds to make my face turn red."	哦 ， 我 最恨 那些 美国 空军 官兵 了 ， 他们 那种 ‘ 好吧 ， 好吧 ’ 的 洋腔 中国话 让 人 听 了 会 忿怒	。												
But the worst were the northern peasants who emptied their noses into their hands and pushed people around and gave everybody their dirty diseases.	然而 最糟 的 是 北方 乡巴佬 ， 他们 用 手 挖 鼻孔 、 擤鼻涕 ， 又 用 那 擤鼻涕 的 手 去 推搡 旁边 的 人	， 龌里	龌	龊	的	。								
So you can see how quickly Kweilin lost its beauty for me.	“ 因 此 你 能 想象 ， 桂林 对 我 很 快 就 失却 了 她 的 种种 魅力 。													
"I no longer climbed the peaks to say, How lovely are these hills!"	我 再 不 想 去 爬山 ， 尽管 它们 是 那么 可爱 。													
I only wondered which hills the Japanese had reached.	我 怀疑 那些 山 已 被 日本 人 践踏 过 了 。													
And then the sound of raining rocks.	然后 砾石 雨点 般 劈头盖脑 地 倾覆 下来 。													
"Can you imagine how it is, to want to be neither inside nor outside, to want to be nowhere and disappear?"	你 能 想象 吗 ？ 生 的 希望 ， 既 不 在 洞里 ， 又 不 在 洞 外 ， 也 不知 究竟 在 何方 ？													
"So when the bombing sounds grew farther away, we would come back out like newborn kittens scratching our way back to the city."	完全 是 一 种 郁闷 而 无望 的 等待 。 “ 因 此 一旦 轰 炸声 远 去 ， 我们 便 像 刚 下地 的 小猫崽 一样	， 抓着	扒	着	拥	上	回城	的 道路	。					
"And always, I would be amazed to find the hills against the burning sky had not been torn apart."	我 常常 十分 诧异 地 发现 ， 那 映着 燃烧 的 天际 的 山峦 ， 竟然 还 是 完好 如初 ， 毫无 损伤 。													
"I thought up Joy Luck on a summer night that was so hot even the moths fainted to the ground, their wings were so heavy with the damp heat."	“ 令 我 生 出 发起 喜福会 这 念头 的 ， 是 在 一个 酷暑 煎 人 的 晚上 。 那天 热 得 连 飞蛾 都 给 暑气	熏 昏	而	坠 在	地	上	，	它们 的	翅膀	几	乎	要	被	潮湿 的 暑气 蒸熟 了 ， 以至 再 也 无力 掀动 。
Every place was so crowded there was no room for fresh air.	反正 ， 处处 都 散发 着 浑浊 的 臭气 ， 没有 一 间 房间 可以 吸到 一 点 清新 的 空气 。													
Unbearable smells from the sewers rose up to my second-story window and the stink had nowhere else to go but into my nose.	那 令 人 翻胃 的 臭气 ， 从 楼下 阴沟 里 泛 出来 ， 往 四下 弥散 ， 直 冲着 二 楼 我 的 窗棂 。													
"At all hours of the night and day, I heard screaming sounds."	它们 无孔不入 ， 甚至 我 的 鼻孔 也 遭了殃 。													
I didn't know if it was a peasant slitting the throat of a runaway pig or an officer beating a half-dead peasant for lying in his way on the sidewalk.	整整 一个 通宵 ， 阵阵 尖锐 刺耳 的 嚎叫 声 没有 平息 过 ， 不知 是 农民 在 杀猪 ， 还是 哪个 当官 的	， 在 当	街	痛打	挡	他	道	的 倒霉	的	乡巴	佬	。		
I knew which women I wanted to ask.	“ 我 便 生 出 了 这样 的 主意 ： 邀集 四 个 女人 来 打 麻将 。													
"They were all young like me, with wishful faces."	我 很 明白 要 邀 的 是 怎样 的 人 ： 她们 大都 像 我 一般 年轻 ， 有生气 。													
She had escaped with only a little money.	在 逃难 出来 时 ， 她 随身 只 携带 了 一点点 钱 。													
Each week one of us would host a party to raise money and to raise our spirits.	她 曾 与 一个 老头 结婚 ， 后来 那 老头 死 了 ， 给 她 留下 一 笔 足以 让 她 养尊处优 度日 的 财产 。													
"The hostess had to serve special dyansyin foods to bring good fortune of all kinds鈥攄umplings shaped like silver money ingots, long rice noodles for long life, boiled peanuts for conceiving sons, and of course, many good-luck oranges for a plentiful, sweet life."	“ 每星期 我们 轮流 做东 。 轮 到 的 女 主人 ， 必须 准备 一些 特别 的 可以 讨 口 彩 的 食品 —— 如 可	称作 金	钱	饼	的	烧饼	，	俗称 长	寿面	的	面	条	一	， 隐喻 得 贵子 的 落花生 ， 还有 ， 人 称 福橘 的 橘子 。
What fine food we treated ourselves to with our meager allowances!	“ 看 ， 以 我们 菲薄 的 经济 力量 ， 却 能 吃 上 这么 好 的 东西 ！													
We didn't notice that the dumplings were stuffed mostly with stringy squash and that the oranges were spotted with wormy holes.	我们 不在乎 金钱 饼 里 的 馅 是 烂 水果 捏成 。 而 所谓 的 福橘 ， 皮 上 满是 斑斑 的 霉点 。													
"We ate sparingly, not as if we didn't have enough, but to protest how we could not eat another bite, we had already bloated ourselves from earlier in the day."	我们 所 吃 有限 ， 倒 并 不 是 因 食物 不足 而 存心 节省 ， 而 是 因为 实在 吃 不 下 了 。 打从 聚 会日	的 大清	早	起	，	我们	便	开始 饱	口	福	了	。		
"After filling our stomachs, we would then fill a bowl with money and put it where everyone could see."	“ 口福 饱 了 后 ， 我们 便 把 钱 装满 一 大 碗 放 在 显眼 之 处 ， 随后 各 人 在 麻将 台 边 各就各位	。												
"The table had a very thick pad, so that when the mah jong pai were spilled onto the table the only sound was of ivory tiles washing against one another."	这 是 一 种 十分 华贵 的 家具 ， 可惜 在 英语 中 ， 找 不 到 合适 的 专用 名词 来 表示 它 。 桌上 铺 着	一 层	厚厚	的	垫衬	，	以	使 麻将	牌	倒	上	去	时	， 只 听见 象牙 块 互相 碰撞 的 闷闷 的 ‘ 噗噗’声 。
"But after sixteen rounds, we would again feast, this time to celebrate our good fortune."	但 打 了 十六 圈 后 ， 我们 又 要 饱 口福 了 ， 以 讨 点 好 口 彩 ， 沾 点 牌运 。													
And a silly foreign lady who fainted on a toilet when firecrackers went off next to her.	此外 ， 有 个 傻乎乎 的 外国 婆娘 在 上厕所 时 ， 被 一 声 爆竹声 吓 得 昏了 过去 。													
We all had our miseries.	我们 也 在 担惊受怕 ， 我们 也 都 有 各自 的 痛苦 。													
How much can you wish for a favorite warm coat that hangs in the closet of a house that burned down with your mother and father inside of it?	当 你家 的 房子 被 烧 了 ， 连同 你 的 父母亲 ， 都 一 起 烧 死 了 ， 你 还 会 想念 一 件 挂 在 房子 壁	橱 里 的	，	你	十	分	心	爱 的 大衣	吗	？				
How long can you see in your mind arms and legs hanging from telephone wires and starving dogs running down the streets with half-chewed hands dangling from their jaws?	当 电线杆 上 挂 着 残存 的 人 手 和 人 腿 ， 饿 狗 满 街 出没 ， 到处 乱窜 ， 它们 爪子 里 ， 还 拖 着	一 只 啃	了	一	半	的	人	手 ， 这时	，	你	的		头脑	还 能 保持 清醒 多久 呢 ？
"And each week, we could hope to be lucky."	我们 赌钱 ， 讲 最 美好 的 故事 。													
"My mother used to end the story on a happy note, bragging about her skill at the game."	我 母亲 ， 通常 总是 以 乐观 的 口气 来 结束 这个 故事 。 她 老 爱 炫耀 自己 的 牌 艺 是 如何 高超 。													
"I won many times and was so lucky the others teased that I had learned the trick of a clever thief, she said."""	“ 我 手气 好 ， 总是 赢家 。 人家 开玩笑 地 称 我 为 ‘ 贼 门槛 ’ ，													
I won tens of thousands of yuan.	” 她 说 ， “ 我 赢 到手 好 几万 呢 。													
But I wasn't rich.	但 我 并未 发财 。													
"And that made us laugh harder, to think a thousand-yuan note wasn't even good enough to rub on our bottoms."	我 曾 说 过 ， 一 张 票面 为 干 数 的 钞票 ， 还 不 够揩 一 次 屁股 呢 ！ ”													
I never thought my mother's Kweilin story was anything but a Chinese fairy tale.	我 从来 只 认为 ， 母亲 的 桂林 故事 ， 不过 是 个 中国 神话 而已 。													
The endings always changed.	故事 的 结局 ， 也 常常 是 多变 的 。													
The story always grew and grew.	她 的 故事 也 因 此 不断 得到 发展 和 补充 。													
"And then one evening, after I had begged her to buy me a transistor radio, after she refused and I had sulked in silence for an hour, she said, Why do you think you are missing something you never had?"""	有 天 晚上 ， 我 向 她 要求 买 架 半导体 收音机 ， 她 没 同意 ， 于是 我 就 生 了 一个 钟头 的 闷气 ，	一声不吭	。	她	便	说	了	： “ 你	为	什么	总		要 惦	记 一些 你 从 不曾 拥有 过 的 东西 呢 ？ ”
And then she told me a completely different ending to the story.	于是 ， 她 将 桂林 故事 的 另 一个 结尾 给 我 讲 开 了 。													
"An army officer came to my house early one morning, she said, ""and told me to go quickly to my husband in Chungking."""	“ 一 天 早上 我家 来 了 个 军官 ， ” 她 说 ， “ 他 是 来 通知 我 立即 去 重庆 我 丈夫 处 。													
And I knew he was telling me to run away from Kweilin.	我 明白 他 是 要 我 离开 桂林 。													
I knew what happened to officers and their families when the Japanese arrived.	一旦 日本 人 打 到 桂林 ， 我们 这些 军人 家属 可是 没好 果子 吃 的 。													
"My friend from Nanking, she was so good to me."	桂林 根本 已 不再 往 外地 发车 了 。													
I packed my things and my two babies into this wheelbarrow and began pushing to Chungking four days before the Japanese marched into Kweilin.	“ 我 把 行李 ， 还有 那 对 双胞胎 孩子 ， 都 放 在 独轮车 上 。 就 在 我 推 车 离开 桂林 的 第四 天 ，	桂林 失	守	了	。									
"Up to the last day, the Kuomintang insisted that Kweilin was safe, protected by the Chinese army."	直到 桂林 失守 的 最后 一 天 ， 国民党 词严义正 地 表示 ， 桂林 是 安全 的 ， 是 受 国军 保护 的 。													
"But later that day, the streets of Kweilin were strewn with newspapers reporting great Kuomintang victories, and on top of these papers, like fresh fish from a butcher, lay rows of people鈥攎en, women, and children who had never lost hope, but had lost their lives instead."	就 在 当天 日本 兵 入侵 桂林 后 ， 满 街 还 散乱地 丢弃 着 关于 报告 国军 大捷 的 号外 ， 而 它们 上边	， 则 躺	满	着	无	辜者	的	尸体 ，	就	像	砧	板	上	的 鱼 一样 ， 横七竖八 的 。 他们 多 为 女人 、 老人 和 小孩 ， 真叫 人 惨不忍睹 。
"When I heard this news, I walked faster and faster, asking myself at each step, Were they foolish?"	毛病 就 出 在 他们 一直 对 国军 怀着 希望 。 结果 你 看 ， 连 命 都 丢 了 。													
I abandoned my beautiful mah jong table of hong mu.	每 跨 一 步 ， 我 就 们 心 自问 ： 他们 是 不 是 很 笨 ？ 他们 这 算 不 算 有 勇气 ？													
By then I didn't have enough feeling left in my body to cry.	“ 我 急急 地 往 重庆 方向 赶路 ， 直到 车轮 终于 报废 了 ， 我 不得不 扔掉 那 张 华丽 的 红木 麻将 台	。 那时	连	哭	都	顾	不	上 了 。						
"Along the way, I saw others had done the same, gradually given up hope."	“ 沿途 ， 人人 都 是 这样 ， 放弃 了 手里 最后 的 希望 。 路面 犹如 是 珍宝 砌成 ， 价值连城 。													
It was like a pathway inlaid with treasures that grew in value along the way.	成匹 成匹 精美 的 锦缎 、 古书 、 祖宗 尊 像 、 木器 家具 …… 还有 整 笼 的 小鸭 。													
"Until one could see cages of ducklings now quiet with thirst and, later still, silver urns lying in the road, where people had been too tired to carry them for any kind of future hope."	一路上 还有 人们 扔下 的 银器 。 但 精疲力竭 的 人们 ， 对 这些 眼睛 都 不 扫 一下 ， 绝望 的 人们 对	什么 都	不	会 动	心	。								
By the time I arrived in Chungking I had lost everything except for three fancy silk dresses which I wore one on top of the other.	最后 ， 待 抵达 重庆 时 ， 我 已 是 子然一身 ， 两手空空 然 ， 除了 套 在 身上 的 三件 漂亮 的 绸衣 。	” “ 子	然	一	身	？	”							
What happened to the babies?	“ 那 …… 两 个 孩子 呢 ？ ”													
She didn't even pause to think.	母亲 头 也 不 抬 ， 干 干脆 脆 地 表示 这个 故事 已经 没有 “ 以后 ” 了 。													
"When I arrive at the Hsus' house, where the Joy Luck Club is meeting tonight, the first person I see is my father."	话 再说 回来 ， 今晚 的 喜福会 活动 在 许 家 。 我 一 进 门 ， 第一 个 见 到 的 ， 却 是 我 爸 。													
"Everybody's already here, seven family friends in their sixties and seventies."	这话 倒 也 不假 ， 其他 各位 都 早已 到齐 了 。 七 家 人家 的 成员 ， 大多 已 七老八十 了 。													
"The last time I saw them, at the funeral, I had broken down and cried big gulping sobs."	我 极力 让 自己 镇静自若 。 上次 见 到 他们 ， 还是 在 我 母亲 的 葬礼 上 。													
They must wonder now how someone like me can take my mother's place.	那时 我 悲痛欲绝 ， 几近 不 能 自持 。 他们 必定 会 嘀咕 ， 我 这样 的 一个 人 ， 怎 能 取代 我 的 母亲	呢 ？												
"A friend once told me that my mother and I were alike, that we had the same wispy hand gestures, the same girlish laugh and sideways look."	一个 朋友 曾 跟 我 说 过 ： 我 长 得 很 像 母亲 ， 举止 文雅 ， 有着 小姑娘 般的 清脆 悦耳 的 笑声 及	娇嗔 的	睇视	。										
"When I shyly told my mother this, she seemed insulted and said, You don't even know little percent of me!"""	有 一 次 我 羞答答 地 把 这话 告诉 母亲 ， 她 却 似 受 了 侮辱 般 申辩 着 ： “ 你 与 我 差 远 了 ， 你	对 我	了解	多	少	？	怕	百分之一	都	没有	！			
How can you be me?	那 怎么 可能 像 我 呢 ？ ” 她 说 得 对 。													
"Auntie, Uncle, I say repeatedly, nodding to each person there."""	“ 阿姨 、 伯伯 。 ” 我 向 在座 的 一一 颔 首 招呼 过 后 ， 并 径自 过去 站 在 父亲 身边 。													
He's looking at the Jongs' pictures from their recent China trip.	爸 正在 看 龚 家 最 近 在 中国 旅游 的 照片 。													
"Look at that, he says politely, pointing to a photo of the Jongs' tour group standing on wide slab steps."""	“ 看看 吧 。 ” 说 着 ， 他 指 着 旅游团 站 在 宽阔 的 石台阶 上 的 团体照 。													
"There is nothing in this picture that shows it was taken in China rather than San Francisco, or any other city for that matter."	这 张 相片 一 点 也 没 显出 什么 中国 的 背景 ， 倒像 是 在 旧金山 或 其他 什么 城市 照 的 。													
But my father doesn't seem to be looking at the picture anyway.	但 父亲 似 只 是 心不在焉 地 粗粗 浏览 着 这些 照片 。													
But what's the Chinese word that means indifferent because you can't see any differences?	但 不知 什么 时候 起 ， 他 变 得 不一样 了 。													
That's how troubled I think he is by my mother's death.	我 想 ， 那 是 因为 母亲 故世 的 缘故 吧 。													
"Will you look at that, he says, pointing to another nondescript picture."""	“ 看 这 一 张 。 ” 他 说 着 ， 手指 着 一 张 说明 不 了 什么 的 照片 。													
The Hsus' house feels heavy with greasy odors.	许 家 的 居室 里 ， 总是 弥漫 着 一 股 浓重 的 油腻味 。													
"Too many Chinese meals cooked in a too small kitchen, too many once fragrant smells compressed onto a thin layer of invisible grease."	在 小小的 厨房 里 烹饪 太 多 的 中国菜 ， 油气 就 很 容易 积淀 起来 。													
"I remember how my mother used to go into other people's houses and restaurants and wrinkle her nose, then whisper very loudly: I can see and feel the stickiness with my nose."""	我 至 今 记得 ， 每每 母亲 上 别人 家 或 餐馆 时 ， 总 会 皱 着 鼻子 轻声 地 ， 却 又 说 得 人人 都 听	见 ： “	我	都	觉得	鼻	子	给 油气	黏住	了	！		”	
"I have not been to the Hsus' house in many years, but the living room is exactly the same as I remember it."	我 已 有 好几 年 没 上 许 家 了 。 但 那间 起居室 还 是 与 我 记忆 中 的 一样 ， 丝毫 没有 变动 。													
"I remember this stuff, because when we were children, Auntie An-mei didn't let us touch any of her new furniture except through the clear plastic coverings."	这些 家具 我 都 记忆犹新 。 因为 在 我们 小时候 ， 安 梅 阿姨 从来 不 让 我们 触摸 一下 她 的 所 有 家	具 ， 除	非	上面	盖	着	塑料	布 。						
"On Joy Luck nights, my parents brought me to the Hsus'."	每逢 喜福会 的 活动日 ， 我 的 父母 便 带 我 一 起 去 许 家 。													
"Since I was the guest, I had to take care of all the younger children, so many children it seemed as if there were always one baby who was crying from having bumped its head on a table leg."	因为 我 是 客人 ， 因此 我 也 必得 看住 其他 的 小孩子 ， 这里 有 这么 多 的 小孩子 ， 似乎 每次 都 会	发生 诸	如	撞 疼	头	跌	痛	脚 的 事	。					
"The Joy Luck aunties are all wearing slacks, bright print blouses, and different versions of sturdy walking shoes."	然而 今天 晚上 ， 一切 都 显得 很 平常 。 喜福会 的 阿姨 都 穿 着 长裤 ， 配 着色 泽 鲜艳 的 花 衬衫 和	式 样 各	异	的	、	结实	的	跑鞋 。						
We are all seated around the dining room table under a lamp that looks like a Spanish candelabra.	我们 围桌 而 坐 ， 餐桌 上端 ， 垂 着 一 盏 西班牙 式 的 枝形 大 吊灯 。													
Uncle George puts on his bifocals and starts the meeting by reading the minutes:	乔治 叔叔 戴上 双 光 眼镜 ， 开始 宣读 会议 记录 ：													
The red bean soup was especially delicious.	喷 ， 赤豆 汤 很 好吃 。													
The March meeting had to be canceled until further notice.	三月份 的 喜福会 聚会 ， 我们 不得不 暂停 一 次 。													
We were sorry to have to bid a fond farewell to our dear friend Suyuan and extended our sympathy to the Canning Woo family.	很遗憾 ， 我们 亲爱 的 朋友 素 云 离开 了 我们 ， 向 坎宁·吴 全家 表示 慰问 。													
"I keep thinking the others will start talking about my mother, the wonderful friendship they shared, and why I am here in her spirit, to be the fourth corner and carry on the idea my mother came up with on a hot day in Kweilin."	我 原 以为 ， 大家 会谈 及 一阵 我 母亲 ， 念叨 着 她 的 种种 好处 。 正 因为 这样 ， 他们 才 让 我 在	麻将 台	上	替代	母	亲	，	以 作为 众	人	的	一	种	寄	托 ， 继续 母亲 的 得 之 于 桂林 那个 暑夜 的 启迪 。
And it seems to me my mother's life has been shelved for new business.	在 我 ， 却 似 觉得 ， 某些 新鲜事 ， 已 填塞 了 母亲 所 留下 的 空缺 。													
"Auntie Ying, who seems to shrink even more every time I see her, reaches into her knitting bag and pulls out the start of a tiny blue sweater."	映映 阿姨 —— 几乎 每 见 着 她 一 次 ， 就 发现 她 增加 了 几 条 皱纹 ， 则 从 编结 袋里 拿 出 一 件	小小的 蓝	衣	服	开始	忙	活	了 。						
The Joy Luck uncles begin to talk about stocks they are interested in buying.	喜福会 的 叔伯 们 开始 谈论 着 他们 感 兴趣 的 股票 。													
"Uncle Jack, who is Auntie Ying's younger brother, is very keen on a company that mines gold in Canada."	杰克 ， 即 映姨 的 弟弟 ， 颇为 热衷 加拿大 某 金矿 公司 发行 的 股票 。													
"It's a great hedge on inflation, he says with authority."""	“ 这 是 对付 通货膨胀 的 最 好 手法 ： 刀 切 豆腐 两 面 光 。 ” 他 挺有 权威性 地 说 。													
"He speaks the best English, almost accentless."	在 这些 人中 他 的 英语 最 好 ， 听 不 出 什么 生硬 做作 之 处 。													
"I think my mother's English was the worst, but she always thought her Chinese was the best."	这些 人 中 要 数 我 妈 的 英语 最 糟糕 ， 而 她 总 强调 ， 她 的 中文 是 众人 中 最 好 的 。													
She spoke Mandarin slightly blurred with a Shanghai dialect.	她 会讲 一 口 标准 的 国语 。 “ 今晚 还 打麻 将 不 ？ ”													
"Later, she says, ""after midnight."""	“ 再 过 一会 ， ” 她 说 ， “ 待 午夜 以后 。 ”													
"After everybody votes unanimously for the Canada gold stock, I go into the kitchen to ask Auntie An-mei why the Joy Luck Club started investing in stocks."	乔治 叔叔 招呼 着 大伙 。 当 大家 一致 同意 认购 加拿大 金矿 的 股票 后 ， 我 便 去 厨房 问安 梅 阿姨	， 为什么	喜	福会	要	做	股	票 生意	。					
"She is stuffing wonton, one chopstick jab of gingery meat dabbed onto a thin skin and then a single fluid turn with her hand that seals the skin into the shape of a tiny nurse's cap."	安 梅姨 说 着 ， 一边 包着 馄饨 。 她 夹 了 一 筷 拌 着 姜丝 的 肉馅 放 在 薄薄的 皮子 上 ， 手指 简单	地 一阵	拨	弄 ，	这	张	皮	子 就 被	捏	成	一	顶	护	士 帽 般的 形状 。
You can't have luck when someone else has skill.	“ 当 有 几 个 叉麻将 的 高手 在 场 时 ， 你 就 不 会 有 好运气 了 。													
Even your mother agreed.	这 一 着 ， 你 妈也 赞同 的 。 ”													
"Forty wonton, eight people, ten each, five row more, she says aloud to herself, and then continues stuffing."""	她 已经 做 了 五行 ， 每 行 八 只 。 “ 五八得四十 ， 八 个 人 每人 吃 十 只 ， 还 得做 五行 。 ”													
We can have stock market luck.	“ 大 家 都 变 聪明 了 。													
"And we can play mah jong for fun, just for a few dollars, winner take all."	如今 ， 我们 都 能 公平 地 平摊 输赢 。 我们 去 股票 市场 寻觅 福气 ， 在 麻将牌 里 寻觅 乐趣 。													
Smart-hanh?	聪明 吗 ？ 哈哈 。 ”													
"She's not stupid, said my mother on one occasion, ""but she has no spine."""	“ 她 一 点 不 笨 ， ” 有 次 妈 对 我 说 ， “ 就 是 没 胆魄 。													
And she almost wanted to drop her things and go right then.	她 一 听 ， 便 火烧眉毛 般 立时三刻 就 要 去 办 。													
And that person told her she can get her brother in bad trouble in China.	当时 那 人 就 跟 她 说 ， 她 这样 做 ， 会 给 她 在 中国 的 兄弟 惹麻烦 的 。													
That person said FBI will put her on a list and give her trouble in the U.S. the rest of her life.	他 还 说 ， 美国 工业 联邦政府 会 因 此 把 她 列入 某种 名册 里 ， 令 她 以后 在 美国 也 会 遭到 某种	麻烦 。												
"That person said, You ask for a house loan and they say no loan, because your brother is a communist."	比如 ， 他们 不 会 让 你 享受 房屋 贷款 ， 因为 你 兄弟 是 个 共产党员 。 我 就 对 她 说 ： 你 怕 啥 。													
"I said, You already have a house!"	你 已经 有 了 一 幢 自己 的 房子 了 。 但 她 还是 胆小 。 ”													
"As I watch Auntie An-mei, I see a short bent woman in her seventies, with a heavy bosom and thin, shapeless legs."	我 现在 看到 的 安 梅 阿姨 ， 是 个 七十 多 岁 、 矮 个头怄 背的 老太太 了 。 她 郁郁寡欢 ， 迈着 瘦骨	伶仃 的	双	腿 忙	碌	着	。							
She has the flattened soft fingertips of an old woman.	她 有 老年 妇人 那种 平坦 而 柔软 的 指尖 。													
I wonder what Auntie An-mei did to inspire a lifelong stream of criticism from my mother.	我 百思不得 其解 ， 究竟 安 梅 阿姨 做 了 些 什么 ， 以至 引起 我 妈 对 她 如此 苛求 。													
"Then again, it seemed my mother was always displeased with all her friends, with me, and even with my father."	其实 岂止 安 梅 阿姨 ， 其他 朋友 ， 乃至 对 我 爸 、 妈 都 觉得 有 种种 的 不够 、 缺陷 和 失调 。													
The elements were from my mother's own version of organic chemistry.	她 跟 我 说 ： “ 火 ” 太 盛 ， 则 脾气大 ， 比如 我 爸 。													
"Too much water and you flowed in too many directions, like myself, for having started half a degree in biology, then half a degree in art, and then finishing neither when I went off to work for a small ad agency as a secretary, later becoming a copywriter."	“ 水 ” 太 多 的 人 ， 流向 也 多 ， 不易 集中 精力 ， 比如 像 我 ： 学 了 半拉子 的 生物 ， 又 转向	艺术 ，	随后	，	当	上	个	小小的 广	告	代	理商		的 秘	书 ， 这时 无论 是 我 的 生物课 还 是 艺术课 ， 都 只 是 半途而废 。 而 现在 ， 又 当 上 个 自由 撰稿人 。
"I used to dismiss her criticisms as just more of her Chinese superstitions, beliefs that conveniently fit the circumstances."	从 前 我 从 不在意 她 那 一 套 ， 将 此 作为 是 中国 人 的 迷信 ， 那 一 套 只 是 适合 中国 的 社会 环	境 。												
"In my twenties, while taking Introduction to Psychology, I tried to tell her why she shouldn't criticize so much, why it didn't lead to a healthy learning environment."	二十 多 岁 时 ， 我 选读 了 心理学 ， 我 便 试图 说服 她 ， 不要 对 人 太 苛求 ， 这 不 是 一 种 好 的	教育 方	法	。										
"Time to eat, Auntie An-mei happily announces, bringing out a steaming pot of the wonton she was just wrapping."""	安 梅 阿姨 端 出 一 锅 热气腾腾 的 馄饨 ， 快乐地 吆喝 着 。													
"There are piles of food on the table, served buffet style, just like at the Kweilin feasts."	桌上 堆 着 大量 的 吃食 ， 晚餐 是 自助餐 的 形式 ， 就 像 桂林 故事 里 的 聚会 一样 。													
"My father is digging into the chow mein, which still sits in an oversize aluminum pan surrounded by little plastic packets of soy sauce."	爸 正在 替 自己 夹 炒面 。 炒面 盛在 一 只 大号 的 铝锅 内 ， 四围 搁 着 小 塑料包 酱油 ， 那 一定 是	安 梅 阿	姨	从 克	莱	门街	买	来 的 。						
Auntie An-mei must have bought this on Clement Street.	馄饨 散发 着 诱人 的 香味 ， 面上 飘着 一 层 葱花 。													
"They push large forkfuls into their mouths, jab at more pieces of pork, one right after the other."	好像 人人 都 处在 饥饿 状态 ， 一个个 狼吞虎咽 。 那 烤 猪肉 ， 被 他们 一 块 接 一 块 地 送入 肚 中 。													
"They are not like the ladies of Kweilin, who I always imagined savored their food with a certain detached delicacy."	他们 与 桂林 的 那些 女人 们 到底 不 一样 ， 他们 的 食品 ， 要 可口 美味 多 了 。 他们 吃 得 很 快 ，	完 了 ，	男	人	们	便	起身	离座 。						
I too put my plate in the sink and wash my hands.	我 也 跟着 把 盆 碟 放入 水槽 内 ， 然后 洗手 。													
"The women are talking about the Jongs' China trip, then they move toward a room in the back of the apartment."	女人 们 正在 谈论 着 龚 家 的 这次 中国 之 行 ， 她们 边 谈 边 向 公寓 后面 走 去 。													
"We pass another room, what used to be the bedroom shared by the four Hsu sons."	另 一 间 房 里 ， 喜福会 的 叔叔 们 早已 在 扑克 桌边 就座 。													
"Uncle George is dealing out cards, fast, as though he learned this technique in a casino."	乔治 叔叔 正在 发牌 ， 手势 之 熟练 ， 就 像 在 赌场 里 混迹 过 似的 。													
"My father is passing out Pall Mall cigarettes, with one already dangling from his lips."	父亲 拿 出 黑 猫 牌 香烟 待客 ， 自己 嘴上 自然也叼 上 一 支 。													
"And then we get to the room in the back, which was once shared by the three Hsu girls."	我们 来到 后房 ， 这 以前 是 许 家 三 个 女 孩子 的 卧室 。													
"Except for the smell of camphor, it feels the same鈥攁s if Rose, Ruth, and Janice might soon walk in with their hair rolled up in big orange-juice cans and plop down on their identical narrow beds."	一切 似乎 都 没 改变 ， 除了 有 一 股 浓重 的 樟脑 味 。 我 觉得 ， 似乎 罗丝 、 露丝 和 盖 丽丝 ， 立	时 会 走	进	来 。										
The white chenille bedspreads are so worn they are almost translucent.	白色 的 线 织 床罩 磨损 得 几乎 成 半透明 状 。													
Rose and I used to pluck the nubs out while talking about our boy problems.	那 阵 ， 罗丝 和 我 两 人 常 爱 躺 在 上面 边 谈论 着 男 孩子 ， 边 拨 着 上面 的 小穗子 。													
"Everything is the same, except now a mahogany-colored mah jong table sits in the center."	什么 都 保持 着 原状 ， 除了 房间 中央 多 了 一 只 桃花心木 的 麻将桌 。													
"And next to it is a floor lamp, a long black pole with three oval spotlights attached like the broad leaves of a rubber plant."	桌边 是 一 盏 黑 杆 落地灯 。 杆 上 挑 起 三 盏 蛋形 的 聚光 灯泡 ， 犹如 一 棵 宽 叶 橡皮树 。													
"The East is where things begin, my mother once told me, the direction from which the sun rises, where the wind comes from."	东方 ， 是 万物 起始 之 源 。 我 妈 说 过 ， 这 是 太阳 升起 的 地方 ， 是 风向 的 起源 。													
"Auntie An-mei, who is sitting on my left, spills the tiles onto the green felt tabletop and then says to me, Now we wash tiles."""	安 梅 阿姨 在 我 左侧 入座 ， 然后 把 麻将牌 往 绿 呢 桌面 上 一 倒 ， 说 ： “ 洗牌 。 ”													
Do you win like your mother?	“ 你 的 牌 艺 有 你 妈 好 吗 ？ ”													
"Jewish mah jong, she says in disgusted tones."""	“ 噢 ， 犹太 麻将 ！ ”													
Not the same thing.	她 不屑 地 拉长 着 声音 。													
"This is what my mother used to say, although she could never explain exactly why."	“ 那 完全 不 一样 。 ” 我 妈 也 常 这么 说 ， 但 她 从不 解释 为什么 。													
"Auntie Lin looks exasperated, as though I were a simple child: How can we play with just three people?"""	我 提 出来 。 琳 达 阿姨 生气 了 ， 觉得 我 像 小孩子 般 不 懂事 ： “ 我们 总共 只 三 个 人 ， 怎么 搓	？												
"Like a table with three legs, no balance."	就 像 只 台子 只 有 三 只 脚 ， 三缺一 。													
"When Auntie Ying's husband died, she asked her brother to join."	映姨 的 丈夫 去世 了 ， 她 就 叫来 了 她 的 兄弟 。													
I couldn't tell by her answer if the games were different or just her attitude toward Chinese and Jewish people.	然而 她 的 回答 ， 却 令 我 弄 不 清 ， 她 所 指 的 是 麻将 玩法 的 不同 ， 还是 对 中国 人 和 犹太人	本身 的	看法	不	同	？								
"She is the fastest, which means I can almost keep up with the others by watching what she does first."	我 跟着 映姨把牌 堆 起来 ， 同时 不 住地 偷眼 注意 着 琳 达姨 ， 她 手脚 最 快 。 我 的 手脚 也 不 比	别人 慢	。											
"I rearrange my tiles, sequences of bamboo and balls, doubles of colored number tiles, odd tiles that do not fit anywhere."	我 开始 整理 我 的 牌 ： 一 串 索 子 和 筒子 ， 还有 好几 对 万 子 ， 其他 零星 的 杂牌 ， 是 不 能 配	上 去 的	。											
"Your mother was the best, like a pro, says Auntie An-mei while slowly sorting her tiles, considering each piece carefully."""	“ 你 妈 的 麻将 打 得 真 好 ， 都 成 专家 了 。 ” 安 梅姨 一边笃 悠悠 地理 着 牌 ， 一边 说 。													
"Now we begin to play, looking at our hands, casting tiles, picking up others at an easy, comfortable pace."	每排 列 一 张 牌 ， 她 都 慎重地 掂量 过 。 现在 开始 了 。													
"The Joy Luck aunties begin to make small talk, not really listening to each other."	大家 一边 从容 地 抓着 牌 ， 一边 开始 聊天 ， 有 一 搭 无 一 搭 的 。													
"They speak in their special language, half in broken English, half in their own Chinese dialect."	她们 用 她们 自己 特殊 的 语言 谈天 ： 一 半 是 洋 不 洋腔 不 腔 的 英文 ， 一 半 是 她们 自己 的 中国	方言 。												
"Auntie Ying mentions she bought yarn at half price, somewhere out in the avenues."	映姨 讲 起 她 买 了 半价 的 毛线 ， 好像 就 是 街上 挑 来 的 便宜货 。													
Auntie Lin explains how mad she got at a store clerk who refused to let her return a skirt with a broken zipper.	她 得意 地 说 。 琳 达姨 则 讲 到 ， 她 怎样 对 一 位 售货员 大 光 其人 ， 因为 他 竟 不 让 她 退 一 条	拉练 已	坏	的	裙	子	。							
"You didn't die, teases Auntie Ying, and then as she laughs Auntie Lin says 'Pung!'"""	“ 哦 ， 琳 达 ， 你 并 没有 死 ， 你 还 好端端 地 坐 在 麻将 台 边 呢 。 ” 映姨挪榆 着 她 ， 一边 咯	咯 地 笑	着	。										
and 'Mah jong!'	琳 达姨 突 的 一 声 “ 碰 ！ ”													
"and then spreads her tiles out, laughing back at Auntie Ying while counting up her points."	然后 啪 啦 一 声 ， 她 把 牌 往 台 上 一 摊 ， “ 和 啦 ！ ” 她 一边 数 着 自己 的 “ 段 头 ” ， 一边	讪笑 着	瞥	了	一	眼映	姨	。						
"Oh, I have a story, says Auntie Ying loudly, startling everybody."""	“ 呵 ， 告诉 你们 一 件 事 ， ” 映姨 冷不丁 开口 ， 她 的 嗓门 很 大 ， 把 大家 都 吓 了 一 跳 。													
"Auntie Ying has always been the weird auntie, someone lost in her own world."	映姨 常常 就 是 这样 让 人 捉摸不透 ， 有 点 自说自话 。													
"Police arrested Mrs. Emerson's son last weekend, Auntie Ying says in a way that sounds as if she were proud to be the first with this big news."""	“ 上 礼拜六 ， 埃默森 太太 的 儿子 给 抓 进去 了 。 ” 映姨 的 口 气 ， 颇 有 点 为 自己 的 消息 灵通	而 得意	。											
Mrs. Chan told me at church.	“ 那 是 张 太太 在 教堂 里 对 我 说 的 。													
Too many TV set found in his car.	说 人家 发现 ， 他 汽车 里 藏 着 大量 电视机 。 ”													
"Auntie Lin quickly says, Aii-ya, Mrs. Emerson good lady,"" meaning Mrs. Emerson didn't deserve such a terrible son."""	琳 达姨 接 口道 ： “ 哎 呀 ， 埃默森 太太 可 是 个 好人 呢 ！ ” 言下之意 ， 可惜 摊上 这么 个 不肖 之	子 。												
"But now I see this is also said for the benefit of Auntie An-mei, whose own youngest son was arrested two years ago for selling stolen car stereos."	现在 想 起来 ， 她 讲 这话 ， 也 是 为着 顾全 安 梅姨 的 面子 ， 不至 令 其 大 难堪 。 两 年 前 ， 安梅	姨 的 儿	子	因	盗卖	汽	车	音响 而	被捕	。				
"Everybody has TVs in China now, says Auntie Lin, changing the subject."""	“ 在 中国 ， 现在 几乎 人人 都 有 电视机 。 ” 琳 达姨 换 了 个 话题 。													
"So when we asked them what we should buy them, they said nothing, it was enough that we would come to visit them."	他们 什么 都 有 ， 因此当 我们 问 ， 需要 带 些 什么 回去 时 ， 他们 则 说 什么 都 不要 ， 只要 回去 看	看 他们	就	足够	了	。								
"But we bought them different things anyway, VCR and Sony Walkman for the kids."	但 不管 怎么 总得 带 点 什么 回去 ， 比如 录像机 和 索尼 的 ‘ 行路人 ’ ， 给 小孩子 们 玩玩 嘛 。 尽	管 他们	说	不 用	啦	，	但	我 想他	们	会	喜	欢	的	。 ”
"My mother told me the other bag contained the most ridiculous clothes, all new: bright California-style beachwear, baseball caps, cotton pants with elastic waists, bomber jackets, Stanford sweatshirts, crew socks."	而 另 一 只 箱子 则 塞满了 可笑 的 衣物 ， 全 是 崭新 的 。 有 色彩鲜艳 的 加尼福尼亚式 的 海滩装 ， 垒	球 帽 ，	宽	紧	腰	的	棉	布 短裤 ，	投	弹	手	外	套 ，	斯丹福t恤 和 水手 袜 。
"My mother had told her, Who wants those useless things?"""	我 妈 曾 劝告 她 ： “ 谁 要 这种 华而不实 的 玩意 ？													
They just want money.	他们 只 需要 钱 。 ”													
But Auntie An-mei said her brother was so poor and they were so rich by comparison.	但 安梅姨 却说 她 的 兄弟 很 穷 ， 相比之下 ， 她 却 富有 多 了 。													
"As my mother told it, Auntie An-mei had cried before she left for China, thinking she would make her brother very rich and happy by communist standards."""	正 如 我 妈 说 ： “ 安梅姨 在 没到 中国 前 ， 曾 以为 她 将 给 她 弟弟 带 去 财富 和 幸福 ， 将 让 她	弟弟 在	中	国 过	上	生	活	水平 中等	的	好	日	子	。	
"And when the suitcases were emptied, the relatives asked what else the Hsus had brought."	当 箱子 给 掏空 时 ， 那些 亲戚 还 在 一个劲 问 ： “ 还有 什么 ？ 还有 什么 ？ ”													
"Auntie An-mei and Uncle George were shaken down, not just for two thousand dollars' worth of TVs and refrigerators but also for a night's lodging for twenty-six people in the Overlooking the Lake Hotel, for three banquet tables at a restaurant that catered to rich foreigners, for three special gifts for each relative, and finally, for a loan of five thousand yuan in foreign exchange to a cousin's so-called uncle who wanted to buy a motorcycle but who later disappeared for good along with the money."	安梅姨 和 乔治 叔叔 被 敲诈 掉 的 不仅仅 只 是 价值 两千 美元 的 电视机 和 冰箱 ， 还有 计 六 个 人 在	环湖 宾	馆	一 夜	的	房	钱	， 在 餐	厅	的	三	桌	外宾	规格 的 筵席 ， 以及 给 每位 亲戚 的 三 份 特殊 礼物 ， 最后 ， 还 把 五千 元 外汇券 “ 借 ” 给 一个 堂妹 的 “ 小叔 ” ， 他 说 要 买 一 辆 摩托 ， 然而 这 人 最后 连 钱 带 人 都 不见 了 。 待 第二 天 他们 坐 火车 离开 杭州 时 ， 许家 夫妇 发现 ， 他们 竟 花 了 九千 美元 来 应付 这些 亲戚 。
"When the train pulled out of Hangzhou the next day, the Hsus found themselves depleted of some nine thousand dollars' worth of goodwill."	几 个 月 后 ， 在 第一 中国 浸礼 会 的 一个 心情 激荡 的 圣诞 礼拜 上 ， 安梅姨 作见证 说 ： “ 施 较之	得 ，	更	令 人	感	到	幸	福 。 ”	她	只	是	以	此	来 平衡 自己 受伤 的 内心 。
"Months later, after an inspiring Christmastime service at the First Chinese Baptist Church, Auntie An-mei tried to recoup her loss by saying it truly was more blessed to give than to receive, and my mother agreed, her longtime friend had blessings for at least several lifetimes."	反正 ， 她 的 老朋友 安 梅姨 所 作 的 施舍 ， 已 够 修好 几 个 来世 了 。 现在 ， 琳 达姨 在 麻将 台上	如此 津	津乐	道	地	称赞	着	她 的 大	陆	亲	友	的	种种	通情达理 之 处 ， 我 想 ， 她 应该 明白 ， 这 会 伤 了 安梅姨 的 心 的 。
"Listening now to Auntie Lin bragging about the virtues of her family in China, I realize that Auntie Lin is oblivious to Auntie An-mei's pain."	琳 达姨 是 在 使 小心眼 ？ 也许 ， 我 妈 只 跟 我 一个 人 讲 过 ， 有关 安 梅 阿姨 夫妇 在 大陆 被 敲竹	杠 的 倒	霉	事	。									
"Is Auntie Lin being mean, or is it that my mother never told anybody but me the shameful story of Auntie An-mei's greedy family?"	其他人 对 此 ， 或者 还 蒙在鼓里 呢 ？ “ 精美 ， 你 还 在 读书 吗 ？ ”													
"So, Jing-mei, you go to school now?"	琳姨 问 我 。 “ 她 叫 琼 。													
"They all go by their American names, says Auntie Ying."""	映 姨说 。 “ 叫 琼 也好 。 ”													
"That's okay, I say, and I really mean it."""	我 说 。 我 倒 宁可 叫 琼 。													
"In fact, it's even becoming fashionable for American-born Chinese to use their Chinese names."	事实上 ， 如今 在 美国 出生 的 华裔 用 中国 名字 ， 倒 变成 时髦 之 举 了 。													
"I know my mother probably told her I was going back to school to finish my degree, because somewhere back, maybe just six months ago, we were again having this argument about my being a failure, a college drop-off,"" about my going back to finish."""	我 知道 ， 妈 肯定 已 跟 她 说 过 ， 我 打算 回 大学 读 完 我 的 学位 。 因为 约 半 年 前 ， 我 与 妈	又 争辩	了	一 次	，	她	认	为 我 是	个	失	败者		， 一	个 大学 的 流生 ， 坚持 要 我 回 校 去 把 学位 读 到 手 。
"Once again I had told my mother what she wanted to hear: You're right."""	我 又 一 次 哄 了 她 ： “ 你 讲 得 对 ， 我 得 考虑 一下 。 ”													
But listening to Auntie Lin tonight reminds me once again: My mother and I never really understood one another.	但 今晚 琳 达姨 又 一 次 提醒 我 ： 我们 母女 俩 ， 从来 没有 互相 了解 过 。 我们 只 是 在 注释 着 彼	此 的 见	解	。										
"We translated each other's meanings and I seemed to hear less than what was said, while my mother heard more."	可 我 听 人 耳 已 打 了 很 大 折扣 ， 而 母亲 听 入耳 的 ， 却 比 我 说 的 内容 要 多 得 多 ……													
No doubt she told Auntie Lin I was going back to school to get a doctorate.	所以 ， 她 才 会 跟 琳 达姨 说 ， 我 打算 回 学校 去 读 个 博士学位 。													
Auntie Lin and my mother were both best friends and arch enemies who spent a lifetime comparing their children.	琳 达姨 与 我 妈 ， 既 是 好 朋友 ， 又 在 明争暗斗 。													
"I was one month older than Waverly Jong, Auntie Lin's prized daughter."	她们 花 了 整整 一生 ， 拿 各自 的 孩子 攀比 着 。													
"From the time we were babies, our mothers compared the creases in our belly buttons, how shapely our earlobes were, how fast we healed when we scraped our knees, how thick and dark our hair, how many shoes we wore out in one year, and later, how smart Waverly was at playing chess, how many trophies she had won last month, how many newspapers had printed her name, how many cities she had visited."	我 比 琳 达姨 的 宝贝 女儿 薇 弗莱 大 一个 月 ， 打从 我们 襁褓 时代 起 ， 我们 的 母亲 们 就 开始 比较	我们 肚	脐	的	折痕	，	耳	垂 的 形	状	，	跌	破	的	膝盖 愈合 时间 的 长短 ， 头发 的 密 疏 与 深浅 ， 穿破 鞋子 的 多少 …… 后来 ， 就 是 薇 弗莱 的 棋 下 得 有 多 好 ， 又 捧 回 了 多少 奖品 ， 多少 报纸 刊出 了 她 的 名字 ， 她 游览 过 多少 城市 ……
I know my mother resented listening to Auntie Lin talk about Waverly when she had nothing to come back with.	我 妈 一 听 琳 达姨 提到 薇 弗莱 ， 心里 就 不 舒坦 ， 自觉 无法 与 她 攀比 。													
At first my mother tried to cultivate some hidden genius in me.	起先 ， 妈 是 挺 想 培养 我 的 。													
She did housework for an old retired piano teacher down the hall who gave me lessons and free use of a piano to practice on in exchange.	她 替 楼下 一个 退休 教师 做 清洁工 ， 而 请 他 做 我 的 免费 钢琴 教师 ， 并 借用 他 的 钢琴 让 我 练	琴 。												
"When I failed to become a concert pianist, or even an accompanist for the church youth choir, she finally explained that I was late-blooming, like Einstein, who everyone thought was retarded until he discovered a bomb."	然而 我 还是 成 不 了 独奏 钢琴家 ， 哪怕 在 教堂 的 青年 唱诗班 上 伴奏 也 没有 资格 。 她 将 此 解释	为 ， 我	是	个	大	器晚	成	者 。						
"Now it is Auntie Ying who wins this hand of mah jong, so we count points and begin again."	比如 爱因斯坦 ， 在 他 发明 原子弹 前 ， 大家 都 以为 他 智力 迟钝 。													
She quickly erases her smile and tries for some modesty.	“ 知道 吗 ， 丽娜 搬 到 树林 区 了 ？ ”													
"Even though Lena and I are still friends, we have grown naturally cautious about telling each other too much."	不管 怎么说 ， 丽娜 和 我 还是 朋友 。													
"It's getting late, I say after we finish the round."""	“ 时间 不早 了 。 ” 当 这 一 圈 完 了 后 ， 我 起身 说 。													
"I start to stand up, but Auntie Lin pushes me back down into the chair."	但 琳 达姨 却 把 我 按 四座 上 。 “ 再 坐 一会 ， 我们 再 聊聊 ， 让 大家 重新 认识 一 下 你 。 ”													
"No, I really must go now, thank you, thank you, I say, glad I remembered how the pretense goes."""	“ 不 ， 我 真的 要 走 了 ， 谢谢 。 ” 我 说 ， 并且 很 高兴 自己 还 记得 应付 这种 客套 的 惯用 托词	。												
"Auntie An-mei leaves the room quickly and returns with a bowl of peanuts, then quietly shuts the door."	我 坐 了 下来 。 安梅姨旋身 出 去 一会 ， 端来 一 碗 花生米 ， 随手 掩 上 门 在 桌边 坐 下 。													
"I think your mother die with an important thought on her mind, she says in halting English."""	半 天 ， 映姨 开口 了 ： “ 我 想 ， 你 母亲 的 死 ， 是 因为 她 冒 出 一个 强烈 的 欲望 。 ”													
"And then she begins to speak in Chinese, calmly, softly."	她 以 不连贯 的 英文 说 着 ， 渐渐 改用 中文 娓娓 地 说开 了 。													
"Your mother was a very strong woman, a good mother."	“ 你 妈 ， 是 个 非常 要 强 的 女人 。													
"She loved you very much, more than her own life."	她 很 爱 你 ， 更 甚于 爱 自己 的 生命 。													
And that's why you can understand why a mother like this could never forget her other daughters.	所以 你 就 该 明白 ， 这样 的 母亲 ， 是 怎么 也 忘 不 了 她 另外 两 个 孩子 。													
"She knew they were alive, and before she died she wanted to find her daughters in China."	她 知道 她们 还 在 人世 ， 还 活 着 ， 在 她 去世 前 ， 她 就 打定主意 去 中国 找 她们 。 ”													
"The babies in Kweilin, I think."	我 立时 想到 ， 桂林 的 那 对 婴孩 ！													
I was not those babies.	我 不 是 她们 中 之一 。													
"And now I feel as if I were in Kweilin amidst the bombing and I can see these babies lying on the side of the road, their red thumbs popped out of their mouths, screaming to be reclaimed."	她 的 另外 两 个 女儿 ！ 瞬时 我 觉得 自己 仿佛 就 置身 在 硝烟弥漫 的 桂林 空袭 之中 ， 我 看见 ， 两	个 婴孩	躺	在	路边	嗷	嗷	啼哭 ，	她们	吮	得	通	红	的 拇指 ， 在 我 眼前 晃动 。
"And now my mother's left me forever, gone back to China to get these babies."	然而 现在 ， 妈妈 已 永远 离开 了 我 ， 她 回 中国 去 照看 这 两 个 孩子 了 ！													
I can barely hear Auntie Ying's voice.	在 我 神情恍惚 之际 ， 远远 飘 来 映姨 的 声音 ：													
"She had searched for years, written letters back and forth, says Auntie Ying."""	“ …… 她 找 了 多少 年 啦 ， 写 了 一 大 堆 信 …… ”													
"My sisters, I repeat to myself, saying these two words together for the first time."	我 机械 地 重复 了 一下 。 这 两 个 字音 在 我 ， 还是 第一 次 发出 。													
"The aunties are all smiling at me, as though I had been a dying person who has now miraculously recovered."	阿姨 们 对 着 我 嘻嘻 笑 着 ， 就 像 我 是 个 死 而 复活 的 人 一样 。													
I can't believe it.	我 弄糊涂 了 。													
My sisters are sending me money?	“ 我 的 姐姐 给 我 的 ？ ”													
I ask.	我 问 。 “ 哪里 。 ”													
"Most times your mother win, so most is her money."	你 母亲 赢得 最 多 ， 所以 这里 的 钱 多半 是 她 赢 来 的 ， 我们 只 添 进 了 些许 零头 。													
"We add just a little, so you can go Hong Kong, take a train to Shanghai, see your sisters."	这样 你 就 可以 用 它 作为 去 香港 的 费用 ， 再 乘 火车 去 上海 看望 你 的 姐姐 们 。													
"See my sisters, I say numbly."""	“ 去 看 我 的 姐姐 。 ” 我 漠然 地 重复 了 一 遍 。													
"I am awed by this prospect, trying to imagine what I would see."	我 有点 害怕 这样 的 会面 ， 想象 不 出 ， 这 将 是 怎样 的 一个 场面 ？													
And I am embarrassed by the end-of-the-year-banquet lie my aunties have told to mask their generosity.	阿姨 们 编造 的 那个 有关 年终 宴会 的 谎话 ， 令 我 窘迫 不已 ，													
"I am crying now, sobbing and laughing at the same time, seeing but not understanding this loyalty to my mother."	我 哭 了 ， 哭着 哭 着 ， 又 笑 了 。 我 见 到 了 母亲 那 颗 拳拳之心 ， 但 又 实在 对 她 一点 也 不 了	解 。												
"You must see your sisters and tell them about your mother's death, says Auntie Ying."""	“ 你 必须 去 看看 你 的 姐姐 ， 把 你 母亲 的 死讯 告诉 她们 。 ”													
"But most important, you must tell them about her life."	映 姨说 ， “ 然而 最 要紧 的 是 ， 你 必须 告诉 她们 你 妈 的 身世 。													
"The mother they did not know, they must now know."	对 这个 母亲 ， 她们 是 一无所知 的 ， 但 她们 必须 知道 。 ”													
"See my sisters, tell them about my mother, I say, nodding."""	“ 去 看望 她们 ， 跟 她们 讲讲 妈妈 。 ” 我 连连 点头 答应 ，													
What will I say?	“ 但是 …… 我 该 怎么 说 呢 ？													
The aunties are looking at me as if I had become crazy right before their eyes.	阿姨 们 面面相觑 了 半 天 ， 好像 我 说 了 什么 神智 不 清 的 话语 。													
How can you say?	安 梅姨 怀疑地 嚷 起来 ， “ 亏 你 说 得 出口 。													
Your mother is in your bones!	你 必须 了解 自己 的 妈妈 ！ ”													
"I hear more choruses of Tell them, tell them"" as each Auntie frantically tries to think what should be passed on."""	刹那间 ， “ 跟 她们 说 …… ” “ 跟 她们 讲 ” ， 就 像 一 曲 多 声部 合唱 ， 直 冲 我 的 耳膜 。													
Her dutiful nature to family.	“ 她 那能 干 的 持家 之 道 。 ”													
"Her hopes, things that matter to her."	“ 她 的 希望 。 ”													
The excellent dishes she cooked.	“ 她 烧 的 那 一 手 好 菜 。 ”													
"Imagine, a daughter not knowing her own mother!"	“ 想想 看 ， 女儿 竟然 不 了解 自己 母亲 ！ ”													
"In me, they see their own daughters, just as ignorant, just as unmindful of all the truths and hopes they have brought to America."	其实 只 是 ， 由 我 联想 到 她们 自己 的 女儿 。 她们 的 女儿 们 ， 也 像 我 这样 ， 对 自己 母亲 带 至	美国 的	准	则	和	企望	一	无所知 ，	而	且	漠	不	关心	。
"They see daughters who grow impatient when their mothers talk in Chinese, who think they are stupid when they explain things in fractured English."	她们 发现 ， 自己 的 女儿 们 不耐烦 母亲 们 的 汉语 交谈 ， 而 当母亲 们 用 结结巴巴 的 英语 向 她们 解	释 ， 或	注	释	某种	意	图	时 ， 女	儿	们	则	耻	笑 她	们 的 英语 ， 认为 她们 脑子 不 大 灵活 。
"They see that joy and luck do not mean the same to their daughters, that to these closed American-born minds joy luck"" is not a word, it does not exist."""	母亲 们 认为 是 快乐 和 幸福 的 ， 在 女儿 眼中 却 不 一定 。 对 这些 根本 没 见 过 世面 的 美国 出生	的 脑袋瓜	，	“	喜	福会	”	三 个 字	是	空	空	然	，	毫无意义 。
They see daughters who will bear grandchildren born without any connecting hope passed from generation to generation.	她们 无奈 地 看 着 这些 女儿 们 长大成人 ， 生儿育女 ， 将来 还 会 儿孙满堂 ， 繁衍 下去 ， 却 看 不 到	将 母亲	们	的	准	则	和	期待 代代	相传	的	可	能	和	希望 。
"I will tell them everything, I say simply, and the aunties look at me with doubtful faces."""	“ 我 会 把 一切 都 告诉 她们 。 ” 我 一 口 答应 着 ， 然而 阿姨 们 却 以 疑惑 的 目光 看 着 我 。													
"I will remember everything about her and tell them, I say more firmly."""	“ 我 会 把 我 所 知 的 一切 ， 都 告诉 她们 。 ” 我 十分 肯定 地 重复 了 一 遍 。													
"And gradually, one by one, they smile and pat my hand."	终于 ， 她们 渐渐 漾 起 微笑 ， 一边 轻轻 拍 着 我 的 手 。													
What more can they ask?	她们 还 能 再 要求 些 什么 ？													
What more can I promise?	我 还 能 再 允诺 些 什么 呢 ？													
"And I am sitting at my mother's place at the mah jong table, on the East, where things begin."	我 则 端坐 在 麻将桌 上 我 母亲 的 位置 上 ， 那 是 东首 ， 万物 起源 之 处 。													
